State,District,Latitude,Longitude,District code,State name,Population,Male,Female,Literate,Male_Literate,Female_Literate,sex_ratio
Andhra Pradesh,Adilabad,19.284513950073435,78.81321233480176,532,ANDHRA PRADESH,2741239,1369597,1371642,1483347,856350,626997,100.14931399528476
Andhra Pradesh,Anantapur,14.312065561843148,77.4601584478577,553,ANDHRA PRADESH,4081148,2064495,2016653,2310960,1338474,972486,97.68262940816035
Andhra Pradesh,Chittoor,13.33109263067696,78.92763898886037,554,ANDHRA PRADESH,4174064,2090204,2083860,2667878,1484794,1183084,99.69648895514504
Andhra Pradesh,East Godavari,16.782718320784902,82.2432074720511,545,ANDHRA PRADESH,5154296,2569688,2584608,3288577,1716933,1571644,100.58061523422299
Andhra Pradesh,Guntur,15.884925767634847,80.58657614107885,548,ANDHRA PRADESH,4887813,2440521,2447292,2960441,1634726,1325715,100.27744075957553
Andhra Pradesh,Hyderabad,17.38971555555556,78.46668888888888,536,ANDHRA PRADESH,3943323,2018575,1924748,2892155,1542688,1349467,95.35181997200995
Andhra Pradesh,Karimnagar,18.515483193277312,79.43765428571413,534,ANDHRA PRADESH,3776269,1880800,1895469,2206829,1257238,949591,100.77993407060826
Andhra Pradesh,Khammam,17.683921325051784,80.67008643892335,541,ANDHRA PRADESH,2797370,1390988,1406382,1630234,901640,728594,101.10669538486314
Andhra Pradesh,Krishna,16.143872753151673,81.14805061000413,547,ANDHRA PRADESH,4517398,2267375,2250023,3009718,1598959,1410759,99.2347097414411
Andhra Pradesh,Kurnool,15.43759715142429,77.90086836581717,552,ANDHRA PRADESH,4053463,2039227,2014236,2127161,1246369,880792,98.77448660693489
Andhra Pradesh,Mahbubnagar,16.639546224256293,77.98933089244859,538,ANDHRA PRADESH,4053028,2050386,2002642,1940646,1158386,782260,97.67146283675366
Andhra Pradesh,Medak,17.889304978038055,78.13778901903379,535,ANDHRA PRADESH,3033288,1523030,1510258,1637137,953406,683731,99.1614085080399
Andhra Pradesh,Nalgonda,17.113250515463907,79.16984453608244,539,ANDHRA PRADESH,3488809,1759772,1729037,2001019,1160757,840262,98.25346692639728
Andhra Pradesh,Nizamabad,18.429485849056604,78.07523490566035,533,ANDHRA PRADESH,2551335,1250641,1300694,1389810,790214,599596,104.00218767815863
Andhra Pradesh,Prakasam,15.489039001601704,80.11665790176184,549,ANDHRA PRADESH,3397448,1714764,1682684,1904435,1107686,796749,98.12918862304085
Andhra Pradesh,Srikakulam,18.570900998697432,84.25874814010675,542,ANDHRA PRADESH,2703114,1341738,1361376,1495381,857824,637557,101.46362404582715
Andhra Pradesh,Vizianagaram,18.28329696032972,83.45982854198873,543,ANDHRA PRADESH,2344474,1161477,1182997,1238388,707503,530885,101.85281327137774
Andhra Pradesh,Warangal,18.01752608695651,79.87422028985509,540,ANDHRA PRADESH,3512576,1759281,1753295,2065023,1179790,885233,99.65974736270101
Andhra Pradesh,West Godavari,16.63297943925236,81.45912990654196,546,ANDHRA PRADESH,3936966,1964918,1972048,2652389,1379223,1273166,100.36286501523219
Arunachal Pradesh,Changlang,27.36048479338845,96.37552644628106,253,ARUNACHAL PRADESH,148226,76948,71278,73174,44027,29147,92.63138743047253
Arunachal Pradesh,East Kameng,27.371194055944056,93.04741486013997,247,ARUNACHAL PRADESH,78690,38775,39915,38449,21599,16850,102.94003868471953
Arunachal Pradesh,East Siang,28.15382352941176,95.06499226006191,251,ARUNACHAL PRADESH,99214,50116,49098,62576,34210,28366,97.96871258679862
Arunachal Pradesh,Kurung Kumey,28.04853351800553,93.24531994459834,256,ARUNACHAL PRADESH,92076,45318,46758,36606,20258,16348,103.17754534622003
Arunachal Pradesh,Lohit,27.946785273972623,96.59670770547945,259,ARUNACHAL PRADESH,145726,76221,69505,83062,48380,34682,91.1887799950145
Arunachal Pradesh,Lower Dibang Valley,28.32651730103806,95.76567335640142,258,ARUNACHAL PRADESH,54080,28053,26027,31849,18087,13762,92.77795601183473
Arunachal Pradesh,Lower Subansiri,27.70849297297297,93.96226108108112,255,ARUNACHAL PRADESH,83030,41843,41187,54057,29470,24587,98.43223478240088
Arunachal Pradesh,Papum Pare,27.273529716981127,93.54468183962264,248,ARUNACHAL PRADESH,176573,89182,87391,121048,65794,55254,97.99174721356327
Arunachal Pradesh,Tawang,27.680683962264148,91.82504245283016,245,ARUNACHAL PRADESH,49977,29151,20826,26073,17720,8353,71.44180302562519
Arunachal Pradesh,Tirap,26.94406229508198,95.41470327868862,254,ARUNACHAL PRADESH,111975,57604,54371,47974,29313,18661,94.38754253176863
Arunachal Pradesh,Upper Siang,28.8309244897959,95.00155765306124,252,ARUNACHAL PRADESH,35320,18699,16621,18195,10723,7472,88.88710626236697
Arunachal Pradesh,Upper Subansiri,28.277196566523585,93.8991435622318,249,ARUNACHAL PRADESH,83448,41758,41690,45278,24807,20471,99.8371569519613
Arunachal Pradesh,West Kameng,27.46486582278483,92.65015750452083,246,ARUNACHAL PRADESH,83947,46155,37792,48492,29566,18926,81.8806196511754
Arunachal Pradesh,West Siang,28.106296920289843,94.53510344202908,250,ARUNACHAL PRADESH,112274,58168,54106,64746,36777,27969,93.01677898500894
Assam,Barpeta,26.427872264631056,90.97912010178116,303,ASSAM,1693622,867004,826618,897058,499038,398020,95.3418900028143
Assam,Bongaigaon,26.45012521994133,90.6734296187684,319,ASSAM,738804,375818,362986,434078,237114,196964,96.58558131861699
Assam,Cachar,24.815570668693017,92.86849650455927,316,ASSAM,1736617,886284,850333,1174128,639946,534182,95.94362529392384
Assam,Darrang,26.58463215962442,92.04141338028155,325,ASSAM,928500,475273,453227,487039,268666,218373,95.36140281480328
Assam,Dhemaji,27.586533438485816,94.71336908517353,308,ASSAM,686133,351249,334884,423028,237761,185267,95.34091200259644
Assam,Dibrugarh,27.30612284482757,95.0998282327587,310,ASSAM,1326335,676434,649901,884531,491361,393170,96.07751827968436
Assam,Goalpara,26.017277777777807,90.59869891598912,302,ASSAM,1008183,513292,494891,563577,304302,259275,96.4151009561809
Assam,Golaghat,26.377219709794485,93.82583397823468,313,ASSAM,1066888,543161,523727,721764,396475,325289,96.42205533902471
Assam,Hailakandi,24.457496089385486,92.59154664804475,318,ASSAM,659296,337890,321406,407366,226836,180530,95.12148924206103
Assam,Jorhat,26.76244824016563,94.30197722567289,312,ASSAM,1092256,556805,535451,794929,432335,362594,96.16490512836631
Assam,Kamrup,26.170939452054807,91.58863273972592,321,ASSAM,1517542,778461,739081,995319,550219,445100,94.94130084872589
Assam,Karbi Anglong,26.08966454598031,93.11536570271832,314,ASSAM,956313,490167,466146,557214,314253,242961,95.09942529790867
Assam,Karimganj,24.69660712250711,92.3679498575498,317,ASSAM,1228686,625864,602822,795297,435942,359355,96.31836948602253
Assam,Kokrajhar,26.497246635730868,90.13997470997688,300,ASSAM,887142,452905,434237,489305,275220,214085,95.87816429494043
Assam,Lakhimpur,27.14128805970149,94.0775949253732,307,ASSAM,1042137,529674,512463,683486,375552,307934,96.7506428482425
Assam,Nagaon,26.26462170626351,92.9306191144708,305,ASSAM,2823768,1439112,1384656,1710716,921850,788866,96.21599986658438
Assam,Nalbari,26.46323767605632,91.40598521126763,323,ASSAM,771639,396006,375633,531771,293184,238587,94.85538097907607
Assam,Sonitpur,26.73514926829268,92.85197804878044,306,ASSAM,1924110,983904,940206,1108572,620525,488047,95.55871304517514
Assam,Tinsukia,27.53549291139241,95.69055949367085,309,ASSAM,1327929,680231,647698,798322,453449,344873,95.2173599850639
Bihar,Araria,26.211528119180603,87.30766554934816,209,BIHAR,2811569,1463333,1348236,1195768,727643,468125,92.13459957507963
Bihar,Aurangabad,24.774291867469877,84.45986024096379,235,BIHAR,2540073,1318684,1221389,1466002,868733,597269,92.6218108356513
Bihar,Aurangabad,24.774291867469877,84.45986024096379,515,MAHARASHTRA,3701282,1924469,1776813,2503837,1430936,1072901,92.32744201127687
Maharashtra,Aurangabad,20.0979228832952,75.32072196796334,235,BIHAR,2540073,1318684,1221389,1466002,868733,597269,92.6218108356513
Maharashtra,Aurangabad,20.0979228832952,75.32072196796334,515,MAHARASHTRA,3701282,1924469,1776813,2503837,1430936,1072901,92.32744201127687
Bihar,Banka,24.832355642023337,86.8664916342413,225,BIHAR,2034763,1067140,967623,965321,590961,374360,90.67441947635737
Bihar,Begusarai,25.54302613168723,86.12560144032932,222,BIHAR,2970541,1567660,1402881,1548673,918507,630166,89.4888560019392
Bihar,Bhagalpur,25.277192885375477,87.04213814229242,224,BIHAR,3037766,1615663,1422103,1573066,937669,635397,88.01977887715445
Bihar,Bhojpur,25.50666439393939,84.49407803030304,231,BIHAR,2728407,1430380,1298027,1599151,973486,625665,90.74700429256562
Bihar,Buxar,25.48593018867924,84.08808081760995,232,BIHAR,1706352,887977,818375,989807,593544,396263,92.16173391878392
Bihar,Darbhanga,26.146187719298258,85.97387352472099,215,BIHAR,3937385,2059949,1877436,1816634,1125566,691068,91.13992627972829
Bihar,Gaya,24.7266541547278,84.94291217765044,236,BIHAR,4391418,2266566,2124852,2297613,1368803,928810,93.74763408610207
Bihar,Gopalganj,26.44874364161851,84.34636127167629,217,BIHAR,2562012,1267666,1294346,1382998,793905,589093,102.10465532719186
Bihar,Jamui,24.78418380462726,86.26316298200514,238,BIHAR,1760405,916064,844341,858588,534385,324203,92.17052520347923
Bihar,Jehanabad,25.155679045643165,84.9208124481328,239,BIHAR,1125313,585582,539731,618881,374412,244469,92.17001205638151
Bihar,Katihar,25.56565356037151,87.70466083591326,212,BIHAR,3071029,1600430,1470599,1280190,762256,517934,91.88774266915767
Bihar,Khagaria,25.53558891454964,86.56593256351037,223,BIHAR,1666886,883786,783100,768028,461153,306875,88.6074230639544
Bihar,Kishanganj,26.324336758321294,87.95045007235886,210,BIHAR,1690400,866970,823430,745056,439921,305135,94.97791157710186
Bihar,Lakhisarai,25.183449321266963,86.12825701357468,227,BIHAR,1000912,526345,474567,507270,305182,202088,90.16272596870874
Bihar,Madhepura,25.77341929460581,86.8978443983403,213,BIHAR,2001762,1047559,954203,834577,517666,316911,91.0882346483587
Bihar,Madhubani,26.41380538172716,86.16328360450552,207,BIHAR,4487379,2329313,2158066,2155338,1340085,815253,92.6481756638116
Bihar,Munger,25.198537962962963,86.54173672839504,226,BIHAR,1367765,729041,638724,801817,473741,328076,87.61153350771768
Bihar,Muzaffarpur,26.18664417177915,85.32745092024543,216,BIHAR,4801062,2527497,2273565,2509232,1487117,1022115,89.95322249640653
Bihar,Nalanda,25.229345508982053,85.48053113772461,229,BIHAR,2877653,1497060,1380593,1519933,919558,600375,92.22028509211387
Bihar,Nawada,24.825708836206903,85.61594568965519,237,BIHAR,2219146,1144668,1074478,1091012,659474,431538,93.86809100979498
Bihar,Pashchim Champaran,27.16064352201258,84.30265911949685,203,BIHAR,3935042,2061110,1873932,1759481,1091226,668255,90.91858270543543
Bihar,Patna,25.40297114503818,85.3198433587787,230,BIHAR,5838465,3078512,2759953,3459679,2028047,1431632,89.65217611625357
Bihar,Purba Champaran,26.68129336734693,85.00382155612242,204,BIHAR,5099371,2681209,2418162,2276957,1407603,869354,90.18923925736487
Bihar,Purnia,25.81714801901739,87.40447606973065,211,BIHAR,3264619,1699370,1565249,1332326,805261,527065,92.10760458287483
Bihar,Rohtas,24.99170460829495,83.9350762672811,234,BIHAR,2959918,1543546,1416372,1799832,1061783,738049,91.7609193376809
Bihar,Saharsa,25.821270696721303,86.54670819672135,214,BIHAR,1900661,997174,903487,804996,506374,298622,90.60474902073258
Bihar,Samastipur,25.793205563909765,85.94833323308269,221,BIHAR,4261566,2230003,2031563,2142880,1293575,849305,91.10135726274807
Bihar,Saran,25.89656077844312,84.82266287425155,219,BIHAR,3951862,2022821,1929041,2157454,1285767,871687,95.36390021657873
Bihar,Sheikhpura,25.12472436548223,85.77839390862943,228,BIHAR,636342,329743,306599,328676,196431,132245,92.98120051070076
Bihar,Sheohar,26.458380748663107,85.29539411764709,205,BIHAR,656246,346673,309573,283698,171645,112053,89.29827243540743
Bihar,Sitamarhi,26.56570069686413,85.61172491289203,206,BIHAR,3423574,1803252,1620322,1436794,885188,551606,89.85554986213796
Bihar,Siwan,26.1736372013652,84.33766552901022,218,BIHAR,3330464,1675090,1655374,1930175,1115906,814269,98.82298861553707
Bihar,Supaul,26.28157893772896,86.78496465201461,208,BIHAR,2229076,1155283,1073793,1033283,647672,385611,92.94631704958871
Bihar,Vaishali,25.8134703180212,85.39247597173153,220,BIHAR,3495021,1844535,1650486,1926740,1152576,774164,89.47978758874187
Chandigarh,Chandigarh,30.7426,76.75872465753424,55,CHANDIGARH,1055450,580663,474787,805438,465346,340092,81.76636017793454
Chhattisgarh,Bastar,19.393866751269048,81.52895126903546,414,CHHATTISGARH,1413199,698487,714712,650863,382335,268528,102.32287787746945
Chhattisgarh,Bilaspur,22.356942982456143,81.99770350877188,30,HIMACHAL PRADESH,381956,192764,189192,287620,155599,132021,98.14695690066611
Chhattisgarh,Bilaspur,22.356942982456143,81.99770350877188,406,CHHATTISGARH,2663629,1351574,1312055,1596560,932474,664086,97.07607574576012
Himachal Pradesh,Bilaspur,31.3780422907489,76.65316079295157,30,HIMACHAL PRADESH,381956,192764,189192,287620,155599,132021,98.14695690066611
Himachal Pradesh,Bilaspur,31.3780422907489,76.65316079295157,406,CHHATTISGARH,2663629,1351574,1312055,1596560,932474,664086,97.07607574576012
Chhattisgarh,Dhamtari,20.554912627291245,81.7569195519348,412,CHHATTISGARH,799781,397897,401884,546833,303924,242909,101.00201811021445
Chhattisgarh,Durg,21.194463849287164,81.33181639511197,409,CHHATTISGARH,3343872,1682101,1661771,2303378,1284612,1018766,98.79139243125115
Chhattisgarh,Jashpur,22.77286167664669,83.8703962075848,402,CHHATTISGARH,851669,424747,426922,495415,280656,214759,100.51206953786607
Chhattisgarh,Korba,22.491712499999995,82.57604326923074,404,CHHATTISGARH,1206640,612915,593725,748759,433391,315368,96.86906014700244
Chhattisgarh,Koriya,23.50412776859501,82.12515636363635,400,CHHATTISGARH,658917,334737,324180,397823,229923,167900,96.84618073293362
Chhattisgarh,Mahasamund,21.223727037773354,82.65925427435384,411,CHHATTISGARH,1032754,511967,520787,637963,364089,273874,101.72276728773535
Chhattisgarh,Raigarh,22.008265068493166,83.27797698630134,403,CHHATTISGARH,1493984,750278,743706,951639,542756,408883,99.1240580158288
Chhattisgarh,Raigarh,22.008265068493166,83.27797698630134,520,MAHARASHTRA,2634200,1344345,1289855,1939994,1059692,880302,95.94672498502989
Maharashtra,Raigarh,18.453257637845976,73.0090609418579,403,CHHATTISGARH,1493984,750278,743706,951639,542756,408883,99.1240580158288
Maharashtra,Raigarh,18.453257637845976,73.0090609418579,520,MAHARASHTRA,2634200,1344345,1289855,1939994,1059692,880302,95.94672498502989
Chhattisgarh,Raipur,20.88603153846152,82.20032759615388,410,CHHATTISGARH,4063872,2048186,2015686,2629749,1493158,1136591,98.41323004844287
Chhattisgarh,Surguja,23.32719278728607,83.23582493887531,401,CHHATTISGARH,2359886,1193129,1166757,1187941,694686,493255,97.78967739448123
Daman and Diu,Daman,20.431616666666677,72.8392366071429,495,DAMAN AND DIU,191173,124659,66514,150348,104316,46032,53.35675723373362
Daman and Diu,Junagadh,20.72568199498111,70.83985639899612,479,GUJARAT,2743082,1404356,1338726,1842818,1046981,795837,95.32668354747656
Gujarat,Junagadh,20.929523011609785,70.54733890140345,479,GUJARAT,2743082,1404356,1338726,1842818,1046981,795837,95.32668354747656
Goa,North Goa,15.548723418714054,73.80667997909038,585,GOA,818008,416677,401331,663060,351738,311322,96.31705133712684
Goa,South Goa,15.195278658183785,73.941792596877,586,GOA,640537,322463,318074,502427,264085,238342,98.63891361179422
Gujarat,Ahmadabad,22.605425564971743,72.23898135593227,474,GUJARAT,7214225,3788051,3426174,5435760,3025463,2410297,90.44688152297844
Gujarat,Amreli,21.04832649310872,71.43457637825426,480,GUJARAT,1514190,771049,743141,995459,558180,437279,96.38051537580621
Gujarat,Anand,22.282718206229863,72.57782051557454,482,GUJARAT,2092745,1087224,1005521,1551253,874481,676772,92.485173248567
Gujarat,Banas Kantha,24.258538965517253,71.93205252873561,469,GUJARAT,3120506,1610379,1510127,1704923,1048402,656521,93.77463317641374
Gujarat,Bharuch,21.75787276237761,72.67326346710801,488,GUJARAT,1551019,805707,745312,1118276,623047,495229,92.5040988845821
Gujarat,Bhavnagar,21.70219390341736,72.16272632761141,481,GUJARAT,2880365,1490201,1390164,1887255,1087371,799884,93.28701295999667
Gujarat,Gandhinagar,23.193679790026252,72.67221679790026,473,GUJARAT,1391753,723864,667889,1030494,582686,447808,92.26719383751643
Gujarat,Jamnagar,22.410600414263328,69.62062005768233,477,GUJARAT,2160119,1114192,1045927,1396534,795140,601394,93.87313856139696
Gujarat,Kachchh,23.48057203301311,68.82192301497916,468,GUJARAT,2092371,1096737,995634,1252319,739239,513080,90.78147267758816
Gujarat,Kheda,22.88765312500002,73.018803515625,483,GUJARAT,2299885,1185727,1114158,1660243,942480,717763,93.96412496299739
Gujarat,Mahesana,23.529355452865065,72.45545194085031,471,GUJARAT,2035064,1056520,978544,1502645,847499,655146,92.61954340665581
Gujarat,Narmada,21.70666386292833,73.68403208722742,487,GUJARAT,590297,301086,289211,370336,211767,158569,96.05594414884784
Gujarat,Navsari,20.866973318871995,72.86184869848157,490,GUJARAT,1329672,678165,651507,1001909,539471,462438,96.06909822830727
Gujarat,Panch Mahals,22.80435606837605,73.61984598290586,484,GUJARAT,2390776,1226961,1163815,1440805,858054,582751,94.85346315001047
Gujarat,Patan,23.80634198473284,71.75162977099237,470,GUJARAT,1343734,694397,649337,837913,494631,343282,93.5109166658266
Gujarat,Porbandar,21.55092351651571,69.71896987722886,478,GUJARAT,585449,300209,285240,393678,221621,172057,95.01380704775673
Gujarat,Rajkot,22.40603377715488,70.83679439383323,476,GUJARAT,3804558,1974445,1830113,2725056,1514075,1210981,92.68999642937635
Gujarat,Sabar Kantha,23.71803594548552,73.13638790459964,472,GUJARAT,2428589,1244231,1184358,1578734,918625,660109,95.18795143345568
Gujarat,Surat,21.25761372772093,72.93488716344339,492,GUJARAT,6081322,3402224,2679098,4571410,2687468,1883942,78.74549118458984
Gujarat,Surendranagar,22.82672007299272,71.48358740875906,475,GUJARAT,1756268,909917,846351,1093626,643221,450405,93.01408809814522
Gujarat,The Dangs,20.801633877551023,73.6883518367347,489,GUJARAT,228291,113821,114470,140968,77314,63654,100.57019354952075
Gujarat,Vadodara,22.26133739279589,73.49433010291594,486,GUJARAT,4165626,2153736,2011890,2893080,1614087,1278993,93.41395602803686
Gujarat,Valsad,20.44238231644259,72.9148584798345,491,GUJARAT,1705678,887222,818456,1170657,655528,515129,92.24929048197633
Haryana,Ambala,30.3503672316384,76.94970310734456,70,HARYANA,1128350,598703,529647,818025,461288,356737,88.46573342709156
Haryana,Bhiwani,28.728868064516128,76.02110225806452,81,HARYANA,1634445,866672,767773,1069871,643158,426713,88.5886471467868
Haryana,Faridabad,28.14873109756098,77.32718536585368,88,HARYANA,1809733,966110,843623,1272739,734940,537799,87.32163004212771
Haryana,Fatehabad,29.57298318584072,75.54608716814157,78,HARYANA,942011,495360,446651,557578,327471,230107,90.16694928940568
Haryana,Gurgaon,28.043894789579163,77.01935130260523,86,HARYANA,1514432,816690,697742,1111116,638666,472450,85.43535490822711
Haryana,Hisar,29.23628731117825,75.84324682779452,80,HARYANA,1743931,931562,812369,1114311,670200,444111,87.205038419343
Haryana,Jhajjar,28.59651868131869,76.61137142857145,83,HARYANA,958405,514667,443738,676091,399480,276611,86.21846747508583
Haryana,Jind,29.45149821958457,76.29598575667653,77,HARYANA,1334152,713006,621146,832758,502049,330709,87.1165179535656
Haryana,Kaithal,29.96068539094649,76.37698930041155,73,HARYANA,1074304,571003,503301,646529,385782,260747,88.14331973737441
Haryana,Karnal,29.703200647249204,76.87488025889972,74,HARYANA,1505324,797712,707612,978013,564516,413497,88.70519686302826
Haryana,Kurukshetra,30.05652659846548,76.78774680306903,72,HARYANA,964655,510976,453679,646893,370828,276065,88.78675319388778
Haryana,Mahendragarh,28.1352161458333,76.14018072916659,84,HARYANA,922088,486665,435423,630255,380440,249815,89.47078585885568
Haryana,Panchkula,30.700897142857134,76.97173238095236,69,HARYANA,561293,299679,261614,405318,229862,175456,87.29807560756676
Haryana,Panipat,29.34352134146342,76.92895914634147,75,HARYANA,1205437,646857,558580,786599,464136,322463,86.35293426522401
Haryana,Rewari,28.19164714828897,76.55956007604564,85,HARYANA,900332,474335,425997,636947,375453,261494,89.80931198414622
Haryana,Rohtak,28.892517647058817,76.53123235294117,82,HARYANA,1061204,568479,492725,747582,436025,311557,86.67426589196786
Haryana,Sirsa,29.63583446327684,74.90970480225988,79,HARYANA,1295189,682582,612607,782897,456968,325929,89.74848443117457
Himachal Pradesh,Chamba,32.66741814595661,76.39354063116366,23,HIMACHAL PRADESH,519080,261320,257760,323842,186064,137778,98.63768559620388
Himachal Pradesh,Hamirpur,31.67668481012659,76.49767088607594,28,HIMACHAL PRADESH,454768,217070,237698,358091,180555,177536,109.50292532362833
Himachal Pradesh,Hamirpur,31.67668481012659,76.49767088607594,168,UTTAR PRADESH,1104285,593537,510748,653299,408125,245174,86.05158566357278
Uttar Pradesh,Hamirpur,25.738158381502892,79.82619479768789,28,HIMACHAL PRADESH,454768,217070,237698,358091,180555,177536,109.50292532362833
Uttar Pradesh,Hamirpur,25.738158381502892,79.82619479768789,168,UTTAR PRADESH,1104285,593537,510748,653299,408125,245174,86.05158566357278
Himachal Pradesh,Kangra,32.14093603238864,76.41205910931173,24,HIMACHAL PRADESH,1510075,750591,759484,1152640,606443,546197,101.18479971116095
Himachal Pradesh,Kinnaur,31.60667184065933,78.51613736263741,34,HIMACHAL PRADESH,84121,46249,37872,60699,36697,24002,81.88717593893922
Himachal Pradesh,Kullu,31.90911922077925,77.40922649350647,26,HIMACHAL PRADESH,437903,225452,212451,307672,174550,133122,94.23336231215514
Himachal Pradesh,Mandi,31.635805940594054,76.96556930693067,27,HIMACHAL PRADESH,999777,498065,501712,723747,393669,330078,100.73223374459157
Himachal Pradesh,Shimla,31.155725451807253,77.62573042168668,33,HIMACHAL PRADESH,814010,425039,388971,612642,342846,269796,91.51419046252227
Himachal Pradesh,Sirmaur,30.682764453961443,77.43184689507493,32,HIMACHAL PRADESH,529855,276289,253566,362645,205617,157028,91.77564072402447
Himachal Pradesh,Solan,31.03864311926604,76.94442140672783,31,HIMACHAL PRADESH,580320,308754,271566,428578,244372,184206,87.95545968635224
Himachal Pradesh,Una,31.58330388349513,76.18353932038836,29,HIMACHAL PRADESH,521173,263692,257481,399715,213281,186434,97.64460051878707
Jammu and Kashmir,Doda,33.359614675767915,76.07163720136518,16,JAMMU AND KASHMIR,409936,213641,196295,219083,138620,80463,91.88077194920452
Jammu and Kashmir,Jammu,32.713199095022645,74.8477520361991,21,JAMMU AND KASHMIR,1529958,813821,716137,1137135,641916,495219,87.99686909037737
Jammu and Kashmir,Kargil,33.565994894894914,76.63675315315312,4,JAMMU AND KASHMIR,140802,77785,63017,86236,56301,29935,81.01433438323585
Jammu and Kashmir,Kathua,32.51781678321678,75.58901398601404,7,JAMMU AND KASHMIR,616435,326109,290326,389204,228499,160705,89.02728842196935
Jammu and Kashmir,Pulwama,33.88414418604652,75.00921860465118,12,JAMMU AND KASHMIR,560440,293064,267376,293958,178326,115632,91.23467911445964
Jammu and Kashmir,Punch,33.791241290322574,74.29593161290322,5,JAMMU AND KASHMIR,476835,251899,224936,261724,163333,98391,89.29610677295265
Jammu and Kashmir,Srinagar,34.27312898550724,75.11021159420288,10,JAMMU AND KASHMIR,1236829,651124,585705,748584,431746,316838,89.95291219491219
Jammu and Kashmir,Udhampur,33.04770670731707,75.15286951219511,19,JAMMU AND KASHMIR,554985,296784,258201,322354,197543,124811,86.99963609898109
Jharkhand,Bokaro,23.6814965034965,85.98398374125864,355,JHARKHAND,2062330,1072807,989523,1273520,759088,514432,92.23681426388903
Jharkhand,Chatra,24.11619945750453,84.93295804701627,347,JHARKHAND,1042886,533935,508951,510061,303902,206159,95.32077874647663
Jharkhand,Deoghar,24.33070100755672,86.75697632241814,350,JHARKHAND,1492073,775022,717051,793538,489837,303701,92.52008330086113
Jharkhand,Dhanbad,23.854509090909097,86.40372924901185,354,JHARKHAND,2684487,1405956,1278531,1722204,1014950,707254,90.93677184776764
Jharkhand,Dumka,24.275006125574265,87.27662450229711,362,JHARKHAND,1321442,668514,652928,672409,406275,266134,97.66856041907873
Jharkhand,Garhwa,24.082114689265527,83.68664265536722,346,JHARKHAND,1322784,683575,639209,653476,405161,248315,93.5097099806166
Jharkhand,Giridih,24.30578509874329,86.08710915619386,349,JHARKHAND,2445474,1258098,1187376,1253475,783736,469739,94.37865730650553
Jharkhand,Godda,24.8189,87.2941735483871,351,JHARKHAND,1313551,677927,635624,604519,376212,228307,93.75994760497812
Jharkhand,Gumla,23.078532948929148,84.55056787479396,366,JHARKHAND,1025213,514390,510823,559720,321795,237925,99.30655728144015
Jharkhand,Jamtara,23.97873318077801,86.95325080091534,363,JHARKHAND,791042,404830,386212,426312,258260,168052,95.401032532174
Jharkhand,Latehar,23.72511185840708,84.48298743362837,359,JHARKHAND,726978,369666,357312,350682,209706,140976,96.65806430669848
Jharkhand,Lohardaga,23.488796043165483,84.6605169064748,356,JHARKHAND,461790,232629,229161,259707,149568,110139,98.50921424242034
Jharkhand,Pakur,24.57260428082189,87.69691969178076,353,JHARKHAND,900422,452661,447761,352881,206989,145892,98.91751222217067
Jharkhand,Palamu,24.196925968109337,84.20310842824594,358,JHARKHAND,1939869,1006302,933567,1024563,621706,402857,92.7720505375126
Jharkhand,Ranchi,23.184235061391547,85.31781937244203,364,JHARKHAND,2914253,1494937,1419316,1911433,1085244,826189,94.94152596397039
Jharkhand,Sahibganj,24.93667989690721,87.68264097938142,352,JHARKHAND,1150567,589391,561176,483263,287303,195960,95.21285530318583
Jharkhand,Simdega,22.608760391198054,84.59193691931536,367,JHARKHAND,599578,300309,299269,343483,191991,151492,99.65369003259975
Karnataka,Bagalkot,16.15860676328503,75.64526070853468,556,KARNATAKA,1889752,950111,939641,1113412,641388,472024,98.898023494097
Karnataka,Bangalore Rural,12.936827087794448,77.47369314775169,583,KARNATAKA,990923,509172,481751,688749,385311,303438,94.61458996174181
Karnataka,Belgaum,16.16107219152853,74.72329042357275,555,KARNATAKA,4779661,2423063,2356598,3052032,1725548,1326484,97.25698423854435
Karnataka,Bellary,15.074377548209377,76.47228471074374,565,KARNATAKA,2452595,1236954,1215641,1421621,813440,608181,98.2769771551731
Karnataka,Bidar,17.950361730769224,77.19459961538459,558,KARNATAKA,1703300,870665,832635,1042673,597198,445475,95.6320743339861
Karnataka,Bijapur,16.84015316666667,75.95909166666665,417,CHHATTISGARH,255230,128663,126567,86919,54076,32843,98.37093803191283
Karnataka,Bijapur,16.84015316666667,75.95909166666665,557,KARNATAKA,2177331,1111022,1066309,1248268,730566,517702,95.9755072356803
Karnataka,Chikmagalur,13.425288289676422,75.67626502311249,570,KARNATAKA,1137961,566622,571339,818345,438257,380088,100.8324773835114
Karnataka,Chitradurga,14.29102220394736,76.57821957236843,566,KARNATAKA,1659456,840843,818613,1087392,607188,480204,97.35622464598028
Karnataka,Davanagere,14.330414586709884,75.91723841166937,567,KARNATAKA,1945497,986400,959097,1308540,720637,587903,97.23205596107056
Karnataka,Dharwad,15.343831376975173,75.13831264108359,562,KARNATAKA,1847023,937206,909817,1301664,711776,589888,97.07759019895306
Karnataka,Gadag,15.507128256880746,75.64861302752298,561,KARNATAKA,1064570,537147,527423,700177,397178,302999,98.18969481352404
Karnataka,Gulbarga,17.070459515951594,76.87503850385033,579,KARNATAKA,2566326,1301755,1264571,1427368,828359,599009,97.1435485171941
Karnataka,Hassan,12.945098749999998,76.11049549999997,574,KARNATAKA,1776421,883667,892754,1225256,668836,556420,101.02832854457617
Karnataka,Haveri,14.737582809224318,75.3961230607966,564,KARNATAKA,1597668,819128,778540,1085443,603793,481650,95.04497465597562
Karnataka,Kodagu,12.39684468085106,75.79336595744688,576,KARNATAKA,554519,274608,279911,412877,215302,197575,101.93111635494961
Karnataka,Kolar,13.312799881235172,78.01376947743476,581,KARNATAKA,1536401,776396,760005,1016219,564110,452109,97.88883507900607
Karnataka,Koppal,15.651253271028034,76.1617048598131,560,KARNATAKA,1389920,699926,689994,809085,468785,340300,98.58099284781534
Karnataka,Mandya,12.574901806239744,76.81570098522172,573,KARNATAKA,1805769,905085,900684,1149649,638668,510981,99.51374732759906
Karnataka,Mysore,12.248100259403367,76.52881802853437,577,KARNATAKA,3001127,1511600,1489527,1962180,1063766,898414,98.53975919555438
Karnataka,Raichur,16.050795353982295,76.87368606194688,559,KARNATAKA,1928812,964511,964301,979769,577213,402556,99.97822730896796
Karnataka,Shimoga,14.063845885634592,75.17882078103197,568,KARNATAKA,1752753,877415,875338,1263016,674938,588078,99.76328191334774
Karnataka,Tumkur,13.592467760074973,77.02297966260545,571,KARNATAKA,2678980,1350594,1328386,1813391,1006024,807367,98.35568646092015
Karnataka,Udupi,13.450404228534568,74.72009990316337,569,KARNATAKA,1177361,562131,615230,926429,465704,460725,109.44601881056195
Kerala,Alappuzha,9.542602965599087,76.38010796263319,598,KERALA,2127789,1013142,1114647,1852797,890552,962245,110.01883250324238
Kerala,Ernakulam,10.004879301987431,76.26957729035381,595,KERALA,3282388,1619557,1662831,2855676,1425723,1429953,102.67196523493772
Kerala,Idukki,9.80480963855423,77.04586641566264,596,KERALA,1108974,552808,556166,923010,471881,451129,100.6074441759164
Kerala,Kannur,11.941523076923056,75.35209891725934,589,KERALA,2523003,1181446,1341557,2138434,1012956,1125478,113.55212172202538
Kerala,Kasaragod,12.33310309912974,75.07768497134369,588,KERALA,1307375,628613,678762,1037492,516476,521016,107.97772238245153
Kerala,Kollam,8.929388820570157,76.6360775852431,600,KERALA,2635375,1246968,1388407,2240273,1074345,1165928,111.34263268985252
Kerala,Kottayam,9.643701174068417,76.46059673302705,597,KERALA,1974551,968289,1006262,1749798,861592,888206,103.92165975240863
Kerala,Kozhikode,11.392924270557026,75.71158720159153,591,KERALA,3086293,1470942,1615351,2615443,1266939,1348504,109.81745031415242
Kerala,Malappuram,10.97329875666072,75.93910775606876,592,KERALA,4112920,1960328,2152592,3311315,1597404,1713911,109.80774645875589
Kerala,Palakkad,10.784926903553291,76.49980490693744,593,KERALA,2809934,1359478,1450456,2239492,1122600,1116892,106.69212741949482
Kerala,Thiruvananthapuram,8.537101759082221,76.88711502868073,601,KERALA,3301427,1581678,1719749,2785408,1354857,1430551,108.72940004223364
Kerala,Thrissur,10.458932647907687,76.12321940836945,594,KERALA,3121200,1480763,1640437,2678548,1282261,1396287,110.78322459434764
Kerala,Wayanad,11.715277464788736,76.07587007042254,590,KERALA,817420,401684,415736,645585,328136,317449,103.49827227372761
Madhya Pradesh,Anuppur,23.18184220430107,81.86560000000007,461,MADHYA PRADESH,749237,379114,370123,436595,254120,182475,97.62841783737873
Madhya Pradesh,Ashoknagar,24.63098846153845,77.82974493927134,459,MADHYA PRADESH,845071,443837,401234,469109,290304,178805,90.40120584809289
Madhya Pradesh,Balaghat,21.80020720640569,80.42170053380796,457,MADHYA PRADESH,1701698,842178,859520,1147623,626468,521155,102.05918463792689
Madhya Pradesh,Barwani,21.702135714285724,74.91004719710673,441,MADHYA PRADESH,1385881,699340,686541,549926,313642,236284,98.16984585466297
Madhya Pradesh,Betul,21.964626315789477,77.7873428189117,447,MADHYA PRADESH,1575362,799236,776126,939769,529783,409986,97.10848860661933
Madhya Pradesh,Bhind,26.35951126187245,78.7618324287653,420,MADHYA PRADESH,1703005,926843,776162,1094917,676513,418404,83.74255402479169
Madhya Pradesh,Bhopal,23.480726143790854,77.39246623093679,444,MADHYA PRADESH,2371061,1236130,1134931,1660690,920314,740376,91.81323970779772
Madhya Pradesh,Burhanpur,21.364567254408065,76.24460478589425,467,MADHYA PRADESH,757847,388504,369343,408679,233073,175606,95.06800444783066
Madhya Pradesh,Chhatarpur,24.813637376460004,79.56449299191374,425,MADHYA PRADESH,1762375,936121,826254,943033,572010,371023,88.2635898564395
Madhya Pradesh,Chhindwara,22.227966971713823,78.76413136439254,455,MADHYA PRADESH,2090922,1064468,1026454,1294198,731294,562904,96.42882641845503
Madhya Pradesh,Damoh,23.76624407960196,79.47049303482588,428,MADHYA PRADESH,1264219,661873,602346,747715,445737,301978,91.0062806610936
Madhya Pradesh,Datia,25.90226439560441,78.63916571428574,422,MADHYA PRADESH,786754,420157,366597,491445,303815,187630,87.25238422780056
Madhya Pradesh,Dewas,22.7851110021322,76.46088805970157,437,MADHYA PRADESH,1563715,805359,758356,925369,550716,374653,94.16372077545542
Madhya Pradesh,Dhar,22.572681718963157,75.1105620736698,438,MADHYA PRADESH,2185793,1112725,1073068,1077338,638479,438859,96.43604664225212
Madhya Pradesh,Dindori,22.83738437047757,81.04332966714911,453,MADHYA PRADESH,704524,351913,352611,378714,222759,155955,100.19834447718611
Madhya Pradesh,Guna,24.49043927178156,77.2235895968791,458,MADHYA PRADESH,1241519,649362,592157,653980,400537,253443,91.19058398859188
Madhya Pradesh,Gwalior,26.04074441964285,78.12782433035713,421,MADHYA PRADESH,2032036,1090327,941709,1357210,803114,554096,86.36941027783408
Madhya Pradesh,Harda,22.227659781121783,77.07022571819435,448,MADHYA PRADESH,570465,294838,275627,352550,203807,148743,93.48421845216696
Madhya Pradesh,Hoshangabad,22.595268801996703,78.02168094841929,449,MADHYA PRADESH,1241350,648725,592625,810644,469199,341445,91.35226791013142
Madhya Pradesh,Indore,22.680265752128648,75.9133801324502,439,MADHYA PRADESH,3276697,1699627,1577070,2309130,1289631,1019499,92.78918256770456
Madhya Pradesh,Jabalpur,23.18525572327043,79.98328754716981,451,MADHYA PRADESH,2463289,1277278,1186011,1756468,980307,776161,92.85457042241391
Madhya Pradesh,Jhabua,22.419578015397768,74.40921616766468,464,MADHYA PRADESH,1025048,515023,510025,352081,214582,137499,99.02955790323928
Madhya Pradesh,Katni,23.724416229116937,80.33819665871127,450,MADHYA PRADESH,1292042,662013,630029,790773,460583,330190,95.16867493538646
Madhya Pradesh,Mandla,22.70348712446353,80.38600543633753,454,MADHYA PRADESH,1054905,525272,529633,604962,348033,256929,100.83023652507651
Madhya Pradesh,Mandsaur,24.19278764044944,75.43588667736759,433,MADHYA PRADESH,1340411,682851,657560,834591,502898,331693,96.29626375300029
Madhya Pradesh,Morena,26.37313504531724,77.88447341389724,419,MADHYA PRADESH,1965970,1068417,897553,1179685,747652,432033,84.00774229537717
Madhya Pradesh,Neemuch,24.70311893333336,75.06608186666664,432,MADHYA PRADESH,826067,422653,403414,508834,307889,200945,95.44803893501287
Madhya Pradesh,Panna,24.451325840092657,80.21133001158752,426,MADHYA PRADESH,1016520,533480,483040,552559,332140,220419,90.5451000974732
Madhya Pradesh,Raisen,23.292518206521724,78.16305495923909,446,MADHYA PRADESH,1331597,700358,631239,820220,479093,341127,90.13090448028008
Madhya Pradesh,Rajgarh,23.785499026425583,76.66431223922116,442,MADHYA PRADESH,1545814,790212,755602,804245,488797,315448,95.6201626905185
Madhya Pradesh,Ratlam,23.503562290502792,75.14895782122909,434,MADHYA PRADESH,1455069,738241,716828,825880,485090,340790,97.0994566814902
Madhya Pradesh,Rewa,24.861184625158856,81.57572465057183,430,MADHYA PRADESH,2365106,1225100,1140006,1441757,845572,596185,93.05411803118113
Madhya Pradesh,Sagar,23.800318709677374,78.71940357771273,427,MADHYA PRADESH,2378458,1256257,1122201,1545719,908607,637112,89.32893508255079
Madhya Pradesh,Satna,24.62777621776502,80.75547048710598,429,MADHYA PRADESH,2228935,1157495,1071440,1371781,801051,570730,92.56541064972203
Madhya Pradesh,Sehore,22.9297199679658,77.06780202883085,445,MADHYA PRADESH,1311332,683743,627589,780362,469208,311154,91.7872650981436
Madhya Pradesh,Seoni,22.33230487804874,79.66053863928111,456,MADHYA PRADESH,1379131,695879,683252,864194,485341,378853,98.18546040331725
Madhya Pradesh,Shahdol,23.44859864559819,81.4596831828442,460,MADHYA PRADESH,1066063,540021,526042,604194,348761,255433,97.41139696419214
Madhya Pradesh,Shajapur,23.566620317220547,76.33555181268885,436,MADHYA PRADESH,1512681,780520,732161,894612,543509,351103,93.80425869932866
Madhya Pradesh,Sheopur,25.78014810996563,77.16911116838484,418,MADHYA PRADESH,687861,361784,326077,328025,208201,119824,90.13029874179068
Madhya Pradesh,Shivpuri,25.37802451874367,77.74861600810549,423,MADHYA PRADESH,1726050,919795,806255,900846,573242,327604,87.65594507471774
Madhya Pradesh,Sidhi,24.17547189952905,82.1053783359498,462,MADHYA PRADESH,1127033,575912,551121,600785,353030,247755,95.69534928947479
Madhya Pradesh,Tikamgarh,25.14099852104666,78.89357064846428,424,MADHYA PRADESH,1445166,760355,684811,747940,459353,288587,90.06464085854634
Madhya Pradesh,Ujjain,23.319288862745065,75.80383717647058,435,MADHYA PRADESH,1986864,1016289,970575,1240990,730817,510173,95.50187003893578
Madhya Pradesh,Umaria,23.59601063063061,80.90879477477475,431,MADHYA PRADESH,644758,330674,314084,356672,210907,145765,94.98297416791159
Madhya Pradesh,Vidisha,23.82838307984792,77.9013507604563,443,MADHYA PRADESH,1458875,769568,689307,862918,512344,350574,89.57064223044617
Maharashtra,Akola,20.746310479041902,77.12122320359276,501,MAHARASHTRA,1813906,932334,881572,1411281,758977,652304,94.5553846582877
Maharashtra,Amravati,21.16520991810736,77.67583503184723,503,MAHARASHTRA,2888445,1480768,1407677,2251875,1207104,1044771,95.0639803129187
Maharashtra,Bhandara,21.211792649727748,80.10950199637024,506,MAHARASHTRA,1200334,605520,594814,899860,488709,411151,98.23193288413265
Maharashtra,Bid,18.952353340080982,75.69319706477731,523,MAHARASHTRA,2585049,1349106,1235943,1718507,987185,731322,91.61200083610925
Maharashtra,Buldana,20.56680611183355,76.39017880364096,500,MAHARASHTRA,2586258,1337560,1248698,1879874,1048892,830982,93.35641017973025
Maharashtra,Chandrapur,20.095609090909075,79.31556380471388,509,MAHARASHTRA,2204307,1123834,1080473,1578615,872565,706050,96.14168996488806
Maharashtra,Dhule,21.274018690400517,74.58719071837263,498,MAHARASHTRA,2050862,1054031,996831,1293916,723388,570528,94.57321463979711
Maharashtra,Gondiya,21.225008411214997,80.17522698598128,507,MAHARASHTRA,1322507,661554,660953,1004243,542837,461406,99.90915329663187
Maharashtra,Hingoli,19.59525302245251,77.09239412780653,512,MAHARASHTRA,1177345,606294,571051,790743,450551,340192,94.18714353102621
Maharashtra,Jalgaon,20.8828943415638,75.55140421810695,499,MAHARASHTRA,4229917,2197365,2032552,2891882,1629223,1262659,92.49951646631305
Maharashtra,Jalna,19.984612534818933,75.98473607242339,514,MAHARASHTRA,1959046,1011473,947573,1195523,699428,496095,93.68248089667249
Maharashtra,Kolhapur,16.44881301587301,74.12897150793648,530,MAHARASHTRA,3876001,1980658,1895343,2825845,1559760,1266085,95.69259306755634
Maharashtra,Latur,18.348687268993856,76.75812607802874,524,MAHARASHTRA,2454196,1273140,1181056,1650672,932432,718240,92.76717407355044
Maharashtra,Nagpur,21.196556862745105,79.02166176470584,505,MAHARASHTRA,4653570,2384975,2268595,3673808,1959220,1714588,95.12028427970944
Maharashtra,Nanded,19.209316983017,77.6829048951049,511,MAHARASHTRA,3361292,1730075,1631217,2189425,1255222,934203,94.28591246044246
Maharashtra,Nandurbar,21.523175625248147,74.32638757443429,497,MAHARASHTRA,1648295,833170,815125,906509,512099,394410,97.83417549839768
Maharashtra,Nashik,20.266912871287143,74.03824168316828,516,MAHARASHTRA,6107187,3157186,2950001,4345366,2397538,1947828,93.43766886081465
Maharashtra,Osmanabad,18.19459456066944,75.99495575313809,525,MAHARASHTRA,1657576,861535,796041,1137810,644304,493506,92.39798731334189
Maharashtra,Parbhani,19.31032425249168,76.70163338870431,513,MAHARASHTRA,1836086,942870,893216,1157814,666291,491523,94.73373847932378
Maharashtra,Pune,18.51696171428573,74.12922881632647,521,MAHARASHTRA,9429408,4924105,4505303,7171723,3940210,3231513,91.49486048733729
Maharashtra,Ratnagiri,17.210195070127703,73.25725893866404,528,MAHARASHTRA,1615069,761121,853948,1199392,619012,580380,112.19608971503874
Maharashtra,Sangli,17.154930181086502,74.70713822937628,531,MAHARASHTRA,2822143,1435728,1386415,2049467,1121550,927917,96.56529649070019
Maharashtra,Satara,17.6737908974359,74.18052064102558,527,MAHARASHTRA,3003741,1510842,1492899,2225694,1201034,1024660,98.81238408781329
Maharashtra,Sindhudurg,16.170948049777163,73.51329008172343,529,MAHARASHTRA,849651,417332,432319,666067,348289,317778,103.59114565861233
Maharashtra,Solapur,17.837357937584812,75.42394823609216,526,MAHARASHTRA,4317756,2227852,2089904,2910676,1651266,1259410,93.8080267450441
Maharashtra,Thane,19.698767747440264,72.79882742564581,517,MAHARASHTRA,11060148,5865078,5195070,8227161,4591396,3635765,88.57631560910187
Maharashtra,Wardha,20.80743024390242,78.57259105691062,504,MAHARASHTRA,1300774,668385,632389,1019458,552617,466841,94.61448117477202
Maharashtra,Washim,20.282282394366213,77.25502394366208,502,MAHARASHTRA,1197160,620302,576858,869917,487703,382214,92.99631469832437
Maharashtra,Yavatmal,20.04258346738159,78.05326371760479,510,MAHARASHTRA,2772348,1419965,1352383,2022574,1115980,906594,95.24058691587469
Manipur,Bishnupur,24.50712111801243,93.8246236024845,275,MANIPUR,237399,118782,118617,156333,87313,69020,99.86109006415114
Manipur,Chandel,24.2635812987013,94.09443844155844,280,MANIPUR,144182,74579,69603,90302,51053,39249,93.32788050255434
Manipur,Churachandpur,24.30309718875504,93.38671506024085,274,MANIPUR,274143,138820,135323,195935,104013,91922,97.48091053162369
Manipur,Senapati,25.08465586034914,94.03366234413956,272,MANIPUR,479148,247323,231825,264477,148012,116465,93.73370046457467
Manipur,Tamenglong,24.98312942238265,93.49450740072204,273,MANIPUR,140651,72371,68280,85006,47403,37603,94.34718326401459
Manipur,Thoubal,24.545392553191498,93.97959893617023,276,MANIPUR,422168,210845,211323,269304,152617,116687,100.22670682254737
Manipur,Ukhrul,25.05900314960629,94.44129566929138,279,MANIPUR,183998,94718,89280,129829,70148,59681,94.25874701746237
Meghalaya,East Garo Hills,25.82728228228228,90.64684924924916,294,MEGHALAYA,317917,161223,156694,192147,102513,89634,97.1908474597297
Meghalaya,East Khasi Hills,25.303763888888884,91.75922519841272,298,MEGHALAYA,825922,410749,415173,578030,287270,290760,101.07705679137379
Meghalaya,Jaintia Hills,25.33959557069844,92.37608160136298,299,MEGHALAYA,395124,196285,198839,187527,87371,100156,101.30116921822861
Meghalaya,South Garo Hills,25.240568578553614,90.64560349127176,295,MEGHALAYA,142334,73170,69164,82062,45003,37059,94.52507858411917
Meghalaya,West Garo Hills,25.495285185185185,90.03709947089942,293,MEGHALAYA,643291,324159,319132,358702,193438,165264,98.44921782211816
Meghalaya,West Khasi Hills,25.500889926739926,91.25364542124538,296,MEGHALAYA,383461,193715,189746,230678,117307,113371,97.95111374958057
Mizoram,Aizawl,23.90781335453101,92.85359459459472,283,MIZORAM,400309,199270,201039,340595,169547,171048,100.88774025191951
Mizoram,Champhai,23.54166580976866,93.24221799485862,284,MIZORAM,125745,63388,62357,100802,51440,49362,98.37350918154856
Mizoram,Kolasib,24.2020004347826,92.73470391304348,282,MIZORAM,83955,42918,41037,65895,34147,31748,95.61722354256955
Mizoram,Lawngtlai,22.36102843137253,92.66964156862753,287,MIZORAM,117894,60599,57295,62861,36444,26417,94.5477648146009
Mizoram,Lunglei,23.007717036172675,92.63512555425892,286,MIZORAM,161428,82891,78537,121122,64515,56607,94.74731876802065
Mizoram,Mamit,23.73852942502819,92.4330803833147,281,MIZORAM,86364,44828,41536,60191,32977,27214,92.65637547961096
Mizoram,Saiha,22.35744801061008,93.02827931034489,288,MIZORAM,56574,28594,27980,42233,21861,20372,97.85269636986781
Mizoram,Serchhip,23.263864705882344,92.914158496732,285,MIZORAM,64937,32851,32086,54476,27598,26878,97.6713037654866
Nagaland,Dimapur,25.814176811594223,93.75074057971014,265,NAGALAND,378811,197394,181417,278037,150142,127895,91.90603564444714
Nagaland,Kohima,25.60311428571428,93.78600657596373,270,NAGALAND,267988,138966,129022,197489,107038,90451,92.84429284861045
Nagaland,Mokokchung,26.478911764705888,94.522426006192,262,NAGALAND,194622,101092,93530,159494,83479,76015,92.51968503937007
Nagaland,Mon,26.69207374301676,95.03072988826828,261,NAGALAND,250260,131753,118507,119626,67432,52194,89.94633898279356
Nagaland,Phek,25.63272986577182,94.56814563758392,266,NAGALAND,163418,83743,79675,105893,57926,47967,95.14228054882199
Nagaland,Tuensang,26.21104453280316,94.85809880715708,267,NAGALAND,196596,101933,94663,117511,63653,53858,92.86786418529819
Nagaland,Wokha,26.202611551155112,94.1990815181518,264,NAGALAND,166343,84505,81838,128208,67385,60823,96.84397372936513
Nagaland,Zunheboto,26.028178205128206,94.50026666666668,263,NAGALAND,140757,71217,69540,102881,53504,49377,97.64522515691479
Orissa,Baleshwar,21.48570932311624,87.08085828011933,377,ORISSA,2320529,1185787,1134742,1621232,902359,718873,95.69526398923247
Orissa,Bhadrak,20.95262735257214,86.81496204516931,378,ORISSA,1506337,760260,746077,1094140,596269,497871,98.13445400257807
Orissa,Cuttack,20.407640646029623,85.7776810228802,381,ORISSA,2624470,1352760,1271710,2011469,1103033,908436,94.00854549217895
Orissa,Dhenkanal,20.79887159353349,85.53226836027711,383,ORISSA,1192811,612593,580218,829910,464093,365817,94.71508815804293
Orissa,Gajapati,19.121080882352945,84.14015091911759,389,ORISSA,577817,282882,294935,262537,153663,108874,104.26078718334853
Orissa,Ganjam,19.2632617564534,84.80297710437702,388,ORISSA,3529031,1779218,1749813,2210050,1262652,947398,98.34730763740025
Orissa,Jharsuguda,21.827058566978184,83.93581682242987,371,ORISSA,579505,296690,282815,405879,228092,177787,95.32340153021673
Orissa,Kalahandi,19.784253092783523,83.1124043814433,395,ORISSA,1576869,787101,789768,802036,484177,317859,100.33883834476134
Orissa,Kandhamal,20.092878624813142,84.02216352765326,390,ORISSA,733110,359945,373165,399786,233900,165886,103.67278334189946
Orissa,Kendrapara,20.606319815982264,86.83763247572003,379,ORISSA,1440361,717814,722547,1089265,579970,509295,100.65936301047347
Orissa,Khordha,20.054162322274863,85.52234834123229,386,ORISSA,2251673,1167137,1084536,1749936,957515,792421,92.92276742147666
Orissa,Koraput,18.82627794779476,82.81278469846964,398,ORISSA,1379647,678809,700838,568090,340843,227247,103.24524277079415
Orissa,Malkangiri,18.25227930367506,81.98293636363628,399,ORISSA,613192,303624,309568,244706,147001,97705,101.95768450451874
Orissa,Mayurbhanj,21.897621545157754,86.4030408052231,376,ORISSA,2519738,1256213,1263525,1369397,794171,575226,100.58206689470654
Orissa,Nayagarh,20.192895622119817,85.05614700460825,385,ORISSA,962789,502636,460153,688362,392333,296029,91.54795915931211
Orissa,Nuapada,20.471309512195116,82.59152536585364,394,ORISSA,610382,301962,308420,299383,180903,118480,102.13867970141939
Orissa,Puri,19.83509174603177,85.86698989898981,387,ORISSA,1698730,865380,833350,1291939,704857,587082,96.2987358154799
Orissa,Rayagada,19.292840020060204,83.45860120361095,396,ORISSA,967911,471960,495951,407735,241959,165776,105.08326976862446
Orissa,Sambalpur,21.515752380952385,84.34958483245157,372,ORISSA,1041099,526877,514222,703691,393192,310499,97.5981111340977
Orissa,Sundargarh,22.06354819277107,84.50524819277099,374,ORISSA,2093437,1061147,1032290,1342322,750147,592175,97.28058412265219
Puducherry,Karaikal,10.876161726078813,79.82369793621002,637,PONDICHERRY,200222,97809,102413,154916,79903,75013,104.70713329039249
Puducherry,Mahe,12.006420793787758,75.28275021570326,636,PONDICHERRY,41816,19143,22673,36470,16610,19860,118.44016089432168
Puducherry,Yanam,16.707695652173904,82.26187304347832,634,PONDICHERRY,55626,27301,28325,39274,19919,19355,103.75077835976705
Punjab,Amritsar,31.548679820627772,74.79883856502238,49,PUNJAB,2490656,1318408,1172248,1684770,932981,751789,88.9139022214671
Punjab,Bathinda,30.190524611973352,75.05685898004438,46,PUNJAB,1388525,743197,645328,844868,488261,356607,86.8313515797292
Punjab,Faridkot,30.591187250996025,74.79751553784862,45,PUNJAB,617508,326671,290837,381285,215767,165518,89.03055367632878
Punjab,Fatehgarh Sahib,30.64290947368421,76.36208394736842,40,PUNJAB,600163,320795,279368,426033,238696,187337,87.08614535762715
Punjab,Firozpur,30.63407535211269,74.40245732394365,43,PUNJAB,2029074,1071637,957437,1227511,707070,520441,89.3434063960091
Punjab,Gurdaspur,32.04283371212125,75.3204064393939,35,PUNJAB,2298323,1212617,1085706,1634719,907660,727059,89.53412330521509
Punjab,Hoshiarpur,31.55157169811319,75.8469857442349,38,PUNJAB,1586625,809057,777568,1199699,637927,561772,96.10793800684007
Punjab,Jalandhar,31.250336907216507,75.54400350515463,37,PUNJAB,2193590,1145211,1048379,1622537,882581,739956,91.54461492249027
Punjab,Kapurthala,31.336592638036837,75.47641165644177,36,PUNJAB,815168,426311,388857,576567,316254,260313,91.21439512468596
Punjab,Ludhiana,30.76596397379912,75.83110851528383,41,PUNJAB,3498739,1867816,1630923,2560225,1428348,1131877,87.31711260638093
Punjab,Mansa,29.919547714285724,75.4304922857143,47,PUNJAB,769751,408732,361019,423560,244037,179523,88.32658074239355
Punjab,Moga,30.756540067340065,75.1600845117845,42,PUNJAB,995746,525920,469826,627889,348549,279340,89.33411925768178
Punjab,Muktsar,30.31243303303303,74.5518747747748,44,PUNJAB,901896,475622,426274,524848,300401,224447,89.62453376841273
Punjab,Patiala,30.214540380693364,76.27505893949697,48,PUNJAB,1895686,1002522,893164,1266791,711052,555739,89.09171070560048
Punjab,Rupnagar,30.910937330754347,76.53743500967126,51,PUNJAB,684627,357485,327142,502731,278534,224197,91.51209141642308
Punjab,Sangrur,30.185045204336895,75.89437014178496,53,PUNJAB,1655169,878029,777140,1002077,570413,431664,88.50960503582456
Rajasthan,Ajmer,26.199300378787903,74.6990419191919,119,RAJASTHAN,2583052,1324085,1258967,1526673,926268,600405,95.08203778458332
Rajasthan,Alwar,27.55271738035265,76.65359630562563,104,RAJASTHAN,3674179,1939026,1735153,2182476,1359829,822647,89.4858036973202
Rajasthan,Banswara,23.453642032967014,74.44246868131869,125,RAJASTHAN,1797485,907754,889731,829343,513854,315489,98.01455019752048
Rajasthan,Baran,24.98023243243244,76.86210651828291,128,RAJASTHAN,1222755,633945,588810,693307,432607,260700,92.88029718666446
Rajasthan,Barmer,25.77070908045978,71.50297126436782,115,RAJASTHAN,2603751,1369022,1234729,1188322,783461,404861,90.1905886099712
Rajasthan,Bharatpur,27.32411858037578,77.21752077244258,105,RAJASTHAN,2548462,1355726,1192736,1480869,943910,536959,87.97765920252323
Rajasthan,Bhilwara,25.45119767759564,74.63947595628417,122,RAJASTHAN,2408523,1220736,1187787,1256126,777582,478544,97.3008906102548
Rajasthan,Bikaner,28.12489068322981,73.26943322981371,101,RAJASTHAN,2363937,1240801,1123136,1278801,782399,496402,90.51701280060219
Rajasthan,Bundi,25.48580716049379,75.79984074074079,121,RAJASTHAN,1110906,577160,533746,585044,371705,213339,92.47799570309793
Rajasthan,Chittaurgarh,24.631623761665463,74.80010997846382,126,RAJASTHAN,1544338,783171,761167,821825,514851,306974,97.19039647790841
Rajasthan,Churu,28.29330375536484,74.65846427038629,102,RAJASTHAN,2039547,1051446,988101,1149269,696729,452540,93.97543953755114
Rajasthan,Dausa,26.91234817629181,76.57342097264443,109,RAJASTHAN,1634409,857787,776622,938051,596935,341116,90.53786079761059
Rajasthan,Dhaulpur,26.72397054945053,77.74476219780222,106,RAJASTHAN,1206516,653647,552869,683098,435721,247377,84.5821980365549
Rajasthan,Dungarpur,23.75104807692308,73.84765641025645,124,RAJASTHAN,1388552,696532,692020,681591,415820,265771,99.35221928066478
Rajasthan,Ganganagar,29.256785412667963,73.56192303262948,99,RAJASTHAN,1969168,1043340,925828,1193343,710908,482435,88.73694097801292
Rajasthan,Hanumangarh,29.1813351791531,74.74632573289902,100,RAJASTHAN,1774692,931184,843508,1034136,624281,409855,90.58446021409303
Rajasthan,Jaipur,27.033459290187885,75.77117286012533,110,RAJASTHAN,6626178,3468507,3157671,4300965,2554793,1746172,91.03833436115309
Rajasthan,Jaisalmer,26.86900838548185,71.18371877346682,114,RAJASTHAN,669919,361708,308211,308653,210415,98238,85.20989306291263
Rajasthan,Jalor,25.07578093797277,72.18647261724662,116,RAJASTHAN,1828730,936634,892096,829582,543923,285659,95.24488754412076
Rajasthan,Jhalawar,24.24725541474657,76.11242891705065,129,RAJASTHAN,1411129,725143,685986,739792,466815,272977,94.60009956656825
Rajasthan,Jhunjhunun,28.13517401247401,75.52840893970894,103,RAJASTHAN,2137045,1095896,1041149,1370360,815834,554526,95.0043617277552
Rajasthan,Jodhpur,26.678460838536967,73.00450847457628,113,RAJASTHAN,3687165,1923928,1763237,2031532,1265753,765779,91.64776436540245
Rajasthan,Karauli,26.51901555555556,76.96081818181815,107,RAJASTHAN,1458248,783639,674609,805849,531904,273945,86.08670574078116
Rajasthan,Kota,25.175718080000014,76.18618928000001,127,RAJASTHAN,1951014,1021161,929853,1298345,765396,532949,91.05841292411286
Rajasthan,Nagaur,27.07862016048146,74.14215667001012,112,RAJASTHAN,3307743,1696325,1611418,1758624,1102750,655874,94.99465019969641
Rajasthan,Pali,25.80490393541874,73.55285640766907,118,RAJASTHAN,2037573,1025422,1012151,1085693,667381,418312,98.70580112383
Rajasthan,Rajsamand,25.24894767441859,73.96570215946844,123,RAJASTHAN,1156597,581339,575258,619139,383334,235805,98.95396661844465
Rajasthan,Sawai Madhopur,26.251081180223288,76.4219283891548,108,RAJASTHAN,1335551,704031,631520,741748,486184,255564,89.70059557036551
Rajasthan,Sikar,27.64644058641976,75.29317422839503,111,RAJASTHAN,2677333,1374990,1302343,1652117,995275,656842,94.71654339304287
Rajasthan,Sirohi,24.7976905263158,72.75309131578943,117,RAJASTHAN,1036346,534231,502115,476806,309900,166906,93.98836832755867
Rajasthan,Tonk,26.153935071707927,75.79192216427637,120,RAJASTHAN,1421326,728136,693190,749659,478329,271330,95.20062186184998
Rajasthan,Udaipur,24.44076752136749,73.84029839743584,130,RAJASTHAN,3068420,1566801,1501619,1582629,973444,609185,95.83980352322982
Sikkim,East,27.29600352941175,88.74908392156858,93,NCT OF DELHI,1709346,907500,801846,1352998,748382,604616,88.35768595041323
Tamil Nadu,Ariyalur,11.190514836795256,79.22249643916912,616,TAMIL NADU,754894,374703,380191,480604,269582,211022,101.46462665097424
Tamil Nadu,Chennai,13.058098905608748,80.28139151846806,603,TAMIL NADU,4646732,2335844,2310888,3776276,1968079,1808197,98.93160673401134
Tamil Nadu,Coimbatore,10.871376995940452,77.07619012178621,632,TAMIL NADU,3458045,1729297,1728748,2635907,1394790,1241117,99.9682529952923
Tamil Nadu,Cuddalore,11.57587300613498,79.63002365371497,617,TAMIL NADU,2605914,1311697,1294217,1815281,1000322,814959,98.66737516362392
Tamil Nadu,Dharmapuri,12.300141200000006,78.11509813333339,630,TAMIL NADU,1506843,774303,732540,917709,527599,390110,94.60637502373102
Tamil Nadu,Dindigul,10.377801390820574,77.78011279554937,612,TAMIL NADU,2159775,1080938,1078837,1481834,816180,665654,99.80563177536547
Tamil Nadu,Erode,11.267012155963302,77.42034334862392,610,TAMIL NADU,2251744,1129868,1121876,1492662,828300,664362,99.29266073559036
Tamil Nadu,Kancheepuram,12.496424756511884,80.08820360135913,604,TAMIL NADU,3998252,2012958,1985294,3013382,1611461,1401921,98.6257040633734
Tamil Nadu,Kanniyakumari,8.183466300191206,77.32053064053538,629,TAMIL NADU,1870374,926345,944029,1548738,780541,768197,101.90900798298689
Tamil Nadu,Karur,10.79532776617955,78.08749686847604,613,TAMIL NADU,1064493,528184,536309,727044,401726,325318,101.53828968692729
Tamil Nadu,Madurai,9.904313833333331,78.01366033333332,623,TAMIL NADU,3038252,1526475,1511777,2273430,1223810,1049620,99.03712802371477
Tamil Nadu,Nagapattinam,10.789468161718286,79.79437299431483,618,TAMIL NADU,1616450,798127,818323,1213008,640916,572092,102.53042435602353
Tamil Nadu,Namakkal,11.33766638477801,78.14624841437633,609,TAMIL NADU,1726601,869280,857321,1176131,653312,522819,98.62426375851278
Tamil Nadu,Perambalur,11.260137758112096,78.86034011799416,615,TAMIL NADU,565223,282157,283066,375823,208011,167812,100.32216106635667
Tamil Nadu,Pudukkottai,10.130514816433578,79.05444484265728,621,TAMIL NADU,1618345,803188,815157,1110545,608776,501769,101.49018660637361
Tamil Nadu,Ramanathapuram,9.31286995153476,78.99185362412462,626,TAMIL NADU,1353445,682658,670787,978946,536487,442459,98.26106190801251
Tamil Nadu,Salem,11.629324202127655,78.2478257978723,608,TAMIL NADU,3482056,1781571,1700485,2285562,1285107,1000455,95.44862371468777
Tamil Nadu,Sivaganga,9.960306580645158,78.56535729032255,622,TAMIL NADU,1339101,668672,670429,959744,526304,433440,100.26275961906586
Tamil Nadu,Thanjavur,10.387692255892237,79.3194869107745,620,TAMIL NADU,2405890,1182416,1223474,1790998,944264,846734,103.47238197047402
Tamil Nadu,Theni,9.924066666666668,77.43458833333332,624,TAMIL NADU,1245899,625683,620216,870080,479403,390677,99.12623485055532
Tamil Nadu,Thiruvallur,13.275858101752885,80.19724702864492,602,TAMIL NADU,3728104,1876062,1852042,2791721,1495711,1296010,98.7196585187483
Tamil Nadu,Thiruvarur,10.368927409395978,79.60322893959727,619,TAMIL NADU,1264277,626693,637584,946471,503085,443386,101.7378525051341
Tamil Nadu,Tiruvannamalai,12.419318947368414,79.23265631578953,606,TAMIL NADU,2464875,1235889,1228986,1626813,909803,717010,99.44145469374676
Tamil Nadu,Vellore,12.784882632293078,79.02643283582084,605,TAMIL NADU,3936331,1961688,1974643,2773928,1504355,1269573,100.66040063455554
Tamil Nadu,Virudhunagar,9.468872195892564,77.87641469194315,625,TAMIL NADU,1942288,967709,974579,1398788,760375,638413,100.70992416108562
Tripura,Dhalai,23.781360477941163,91.94654283088232,291,TRIPURA,378230,194544,183686,276217,151643,124574,94.41874331770704
Tripura,North Tripura,24.121739755351683,92.17842538226292,292,TRIPURA,693947,352860,341087,520402,275646,244756,96.66354928300176
Tripura,South Tripura,23.211874098057383,91.6065807585568,290,TRIPURA,876001,447544,428457,646810,351082,295728,95.73516793879485
Tripura,West Tripura,23.780166241299337,91.41310788863107,289,TRIPURA,1725739,879428,846311,1361354,722998,638356,96.2342568123826
Uttar Pradesh,Agra,26.99512974910393,78.05278291517321,146,UTTAR PRADESH,4418797,2364953,2053844,2680510,1614594,1065916,86.8450239814491
Uttar Pradesh,Aligarh,27.93748576850093,78.00146831119557,143,UTTAR PRADESH,3673889,1951996,1721893,2092567,1283380,809187,88.21191231949246
Uttar Pradesh,Allahabad,25.392038662316445,82.05172446982063,175,UTTAR PRADESH,5954391,3131807,2822584,3665727,2199340,1466387,90.1263711333425
Uttar Pradesh,Ambedkar Nagar,26.39119025974028,82.68282142857147,178,UTTAR PRADESH,2397888,1212410,1185478,1486939,846676,640263,97.77863923920125
Uttar Pradesh,Auraiya,26.66892394014961,79.42637057356607,162,UTTAR PRADESH,1379545,740040,639505,930836,546198,384638,86.4149235176477
Uttar Pradesh,Azamgarh,26.008290954773837,83.01220251256285,191,UTTAR PRADESH,4613913,2285004,2328909,2771917,1559414,1212503,101.92144083774033
Uttar Pradesh,Baghpat,29.045793499999988,77.30266300000001,139,UTTAR PRADESH,1303048,700070,602978,797970,489858,308112,86.13110117559673
Uttar Pradesh,Bahraich,27.691776300578027,81.46779783237004,180,UTTAR PRADESH,3487731,1843884,1643847,1398368,878285,520083,89.15132405292306
Uttar Pradesh,Ballia,25.86075638297873,84.03651978723408,193,UTTAR PRADESH,3239774,1672902,1566872,1963590,1160960,802630,93.66191205462125
Uttar Pradesh,Balrampur,27.449076537911324,82.47158326180256,182,UTTAR PRADESH,2148665,1114721,1033944,868357,544943,323414,92.75361278741497
Uttar Pradesh,Banda,25.351885902503284,80.52487391304344,170,UTTAR PRADESH,1799410,965876,833534,1002937,630626,372311,86.29824118209791
Uttar Pradesh,Bara Banki,26.922777025232424,81.35762350597606,176,UTTAR PRADESH,3260699,1707073,1553626,1692458,1010518,681940,91.01110497324953
Uttar Pradesh,Bareilly,28.51101940789474,79.43187072368416,150,UTTAR PRADESH,4448359,2357665,2090694,2191759,1342697,849062,88.67646591012718
Uttar Pradesh,Basti,26.833880454545447,82.69790590909092,185,UTTAR PRADESH,2464464,1255272,1209192,1393783,819719,574064,96.32908246180908
Uttar Pradesh,Bijnor,29.313974259681096,78.45098815489754,134,UTTAR PRADESH,3682713,1921215,1761498,2135393,1241471,893922,91.68666703101943
Uttar Pradesh,Bulandshahr,28.34875862068968,78.01082758620684,142,UTTAR PRADESH,3499171,1845260,1653911,2031656,1253314,778342,89.6302418087424
Uttar Pradesh,Chandauli,25.1180859611231,83.25307062634984,196,UTTAR PRADESH,1952756,1017905,934851,1174606,699454,475152,91.84069240253265
Uttar Pradesh,Chitrakoot,25.159924623803,81.07666087551297,171,UTTAR PRADESH,991730,527721,464009,531072,330339,200733,87.92695382598001
Uttar Pradesh,Deoria,26.42218856548857,83.8244070686071,190,UTTAR PRADESH,3100946,1537436,1563510,1875239,1079288,795951,101.6959405139466
Uttar Pradesh,Etah,27.591155309734443,78.70021858407083,201,UTTAR PRADESH,1774480,947339,827141,1055202,647042,408160,87.31203930166498
Uttar Pradesh,Etawah,26.78817670157068,79.07621806282728,161,UTTAR PRADESH,1581810,845856,735954,1062003,623583,438420,87.00700828509818
Uttar Pradesh,Faizabad,26.60589185185181,82.00783530864202,177,UTTAR PRADESH,2470996,1259628,1211368,1450901,838339,612562,96.1687101271169
Uttar Pradesh,Farrukhabad,27.45063297872342,79.4406284574468,159,UTTAR PRADESH,1885204,1006240,878964,1092677,654827,437850,87.35132771505803
Uttar Pradesh,Fatehpur,25.8374362030905,80.85416203090509,172,UTTAR PRADESH,2632733,1384722,1248011,1512166,911003,601163,90.12718798430298
Uttar Pradesh,Firozabad,27.20963993055552,78.42660624999998,147,UTTAR PRADESH,2498156,1332046,1166110,1521806,912314,609492,87.54277254689401
Uttar Pradesh,Gautam Buddha Nagar,28.393311038961038,77.52462467532465,141,UTTAR PRADESH,1648115,890214,757901,1122947,666065,456882,85.13694459983779
Uttar Pradesh,Ghaziabad,28.74997308584685,77.67441879350343,140,UTTAR PRADESH,4681645,2488834,2192811,3123264,1811397,1311867,88.10595644386086
Uttar Pradesh,Ghazipur,25.624724775583484,83.5360854578097,195,UTTAR PRADESH,3620268,1855075,1765193,2197549,1293553,903996,95.15480506178996
Uttar Pradesh,Gonda,27.157215552099505,82.0226888024882,183,UTTAR PRADESH,3433919,1787146,1646773,1679994,1034181,645813,92.1454094964821
Uttar Pradesh,Gorakhpur,26.63315886792452,83.3549560377358,188,UTTAR PRADESH,4440895,2277777,2163118,2700328,1593890,1106438,94.96618852503998
Uttar Pradesh,Hardoi,27.337409090909137,80.26411767676768,155,UTTAR PRADESH,4092845,2191442,1901403,2221601,1374587,847014,86.76492464778899
Uttar Pradesh,Jalaun,26.067954587155988,79.36686911314993,165,UTTAR PRADESH,1689974,906092,783882,1075196,653430,421766,86.51240712863594
Uttar Pradesh,Jaunpur,25.70141280913127,82.54315351934063,194,UTTAR PRADESH,4494204,2220465,2273739,2731677,1565394,1166283,102.39922718889962
Uttar Pradesh,Jhansi,25.45581535234902,78.89954580536917,166,UTTAR PRADESH,1998603,1057436,941167,1304513,783705,520808,89.00463006744617
Uttar Pradesh,Jyotiba Phule Nagar,28.870498984771597,78.39009365482241,137,UTTAR PRADESH,1840221,963449,876772,983110,600541,382569,91.00346774972002
Uttar Pradesh,Kannauj,26.993988617886185,79.64437940379408,160,UTTAR PRADESH,1656616,881776,774840,1017087,603596,413491,87.8726570013246
Uttar Pradesh,Kanpur Dehat,26.43047641196011,79.98710083056478,163,UTTAR PRADESH,1796184,963255,832929,1170243,692964,477279,86.47024931093013
Uttar Pradesh,Kaushambi,25.53587532051282,81.41811282051287,174,UTTAR PRADESH,1599596,838485,761111,813424,507279,306145,90.77216646690161
Uttar Pradesh,Kushinagar,26.892530675909864,83.92261542461007,189,UTTAR PRADESH,3564544,1818055,1746489,1954820,1183722,771098,96.06359543578165
Uttar Pradesh,Lalitpur,24.58877161016945,78.60082330508473,167,UTTAR PRADESH,1221592,641011,580581,641191,397586,243605,90.5727046805749
Uttar Pradesh,Lucknow,26.838233589251463,80.89706026871404,157,UTTAR PRADESH,4589838,2394476,2195362,3127260,1742440,1384820,91.68444369457033
Uttar Pradesh,Mahoba,25.34529670138888,79.67863003472216,169,UTTAR PRADESH,875958,466358,409600,488106,302283,185823,87.82952152638101
Uttar Pradesh,Mainpuri,27.17386862302482,79.03501851015807,148,UTTAR PRADESH,1868529,993377,875152,1203885,712110,491775,88.09867754135641
Uttar Pradesh,Mathura,27.59390432801821,77.62153416856502,145,UTTAR PRADESH,2547184,1367125,1180059,1507746,943346,564400,86.31683276949803
Uttar Pradesh,Mau,26.01082203791469,83.50582654028433,192,UTTAR PRADESH,2205968,1114709,1091259,1363044,773082,589962,97.89631195226737
Uttar Pradesh,Meerut,29.02957625698323,77.80611005586593,138,UTTAR PRADESH,3443689,1825743,1617946,2141488,1254520,886968,88.61849668874535
Uttar Pradesh,Mirzapur,25.10207959183675,82.60126628571429,199,UTTAR PRADESH,2496970,1312302,1184668,1428683,865837,562846,90.27403753099516
Uttar Pradesh,Moradabad,28.851770406189537,78.73580193423597,135,UTTAR PRADESH,4772006,2503186,2268820,2263848,1357435,906413,90.63729183528511
Uttar Pradesh,Muzaffarnagar,29.470507977736563,77.64017847866423,133,UTTAR PRADESH,4143512,2193434,1950078,2417339,1448528,968811,88.90525085322831
Uttar Pradesh,Pilibhit,28.52024175035868,79.90103974175037,151,UTTAR PRADESH,2031007,1072002,959005,1061095,654290,406805,89.45925474019639
Uttar Pradesh,Pratapgarh,25.864842731707316,81.93530048780492,131,RAJASTHAN,867848,437744,430104,401515,250122,151393,98.25468767133302
Uttar Pradesh,Pratapgarh,25.864842731707316,81.93530048780492,173,UTTAR PRADESH,3209141,1606085,1603056,1931559,1121381,810178,99.81140475130519
Uttar Pradesh,Rae Bareli,26.253902840059787,81.22260463378181,158,UTTAR PRADESH,3405559,1752542,1653017,1965843,1165965,799878,94.32110614182142
Uttar Pradesh,Rampur,28.83244727272725,79.10977333333337,136,UTTAR PRADESH,2335819,1223889,1111930,1043666,630408,413258,90.852193295307
Uttar Pradesh,Saharanpur,30.03381165217392,77.59905147826095,132,UTTAR PRADESH,3466382,1834106,1632276,2077108,1220114,856994,88.99572870924581
Uttar Pradesh,Sant Kabir Nagar,26.791596516393444,83.0387764344262,186,UTTAR PRADESH,1715183,869656,845527,954949,567098,387851,97.22545466253322
Uttar Pradesh,Shahjahanpur,27.991389350649328,79.8302275324675,152,UTTAR PRADESH,3006538,1606403,1400135,1490930,915142,575788,87.15963553354918
Uttar Pradesh,Sitapur,27.501995963091108,80.85288881199547,154,UTTAR PRADESH,4483992,2375264,2108728,2283733,1397702,886031,88.77867891737507
Uttar Pradesh,Sonbhadra,24.46693268858798,83.06816324951639,200,UTTAR PRADESH,1862559,971344,891215,985708,601988,383720,91.75070829695761
Uttar Pradesh,Sultanpur,26.2846386419753,82.05710456790123,179,UTTAR PRADESH,3797117,1914586,1882531,2239902,1300248,939654,98.32574770733726
Uttar Pradesh,Unnao,26.63163990895297,80.636773292868,156,UTTAR PRADESH,3108367,1630087,1478280,1773584,1053063,720521,90.68718418096702
Uttar Pradesh,Varanasi,25.36057088888889,82.82529666666672,197,UTTAR PRADESH,3676841,1921857,1754984,2403903,1389116,1014787,91.31709591296334
Uttaranchal,Almora,29.683532133676103,79.50165064267351,64,UTTARAKHAND,622506,291081,331425,436497,231604,204893,113.86005957104723
Uttaranchal,Bageshwar,29.98703393393397,79.83954354354357,63,UTTARAKHAND,259898,124326,135572,179483,97546,81937,109.04557373357142
Uttaranchal,Chamoli,30.58338611464965,79.56281095541402,57,UTTARAKHAND,391605,193991,197614,280556,155395,125161,101.86761241500895
Uttaranchal,Champawat,29.29142393939393,80.07720212121217,65,UTTARAKHAND,259648,131125,128523,177726,102015,75711,98.01563393708294
Uttaranchal,Pithoragarh,30.14720631868129,80.34229230769236,62,UTTARAKHAND,483439,239306,244133,345550,189623,155927,102.01708273089685
Uttaranchal,Tehri Garhwal,30.463700918635173,78.48783792650917,59,UTTARAKHAND,618931,297986,320945,407994,227406,180588,107.7047243830247
Uttaranchal,Udham Singh Nagar,29.02779577677222,79.45629004524895,67,UTTARAKHAND,1648902,858783,790119,1037839,598525,439314,92.00449939041644
Uttaranchal,Uttarkashi,30.968958552036234,78.56880615384617,56,UTTARAKHAND,330086,168597,161489,215126,128237,86889,95.78402937181562
West Bengal,Bankura,23.081280892857155,87.12640053571437,339,WEST BENGAL,3596674,1838095,1758579,2232992,1299337,933655,95.67399943963724
West Bengal,Barddhaman,23.444453888888884,87.8150581111111,335,WEST BENGAL,7717563,3966889,3750674,5247208,2918040,2329168,94.54950718308478
West Bengal,Birbhum,24.06389342723,87.65153089201888,334,WEST BENGAL,3502404,1790920,1711484,2158447,1201481,956966,95.5645143278315
West Bengal,Dakshin Dinajpur,25.342094363021435,88.69821679819614,331,WEST BENGAL,1676276,857199,819077,1083685,596474,487211,95.55272462987008
West Bengal,Darjiling,26.839619571045585,88.33145067024122,327,WEST BENGAL,1846823,937259,909564,1315585,717673,597912,97.04510706218879
West Bengal,Haora,22.401674174428507,87.99421176968654,341,WEST BENGAL,4850029,2500819,2349210,3605206,1942824,1662382,93.93762603371135
West Bengal,Hugli,22.87929264705881,88.00010264705891,338,WEST BENGAL,5519145,2814653,2704492,4078388,2211777,1866611,96.08616053204427
West Bengal,Jalpaiguri,26.62642031250004,89.04154375000003,328,WEST BENGAL,3872846,1983064,1889782,2498780,1396622,1102158,95.29606709617036
West Bengal,Kolkata,22.550581481481483,88.3527648148148,342,WEST BENGAL,4496694,2356766,2139928,3588137,1926915,1661222,90.79934113102446
West Bengal,Maldah,25.08026802575105,88.17191684549356,332,WEST BENGAL,3988845,2051541,1937304,2086432,1152019,934413,94.43164918468605
West Bengal,Murshidabad,24.25950655391121,88.16816860465121,333,WEST BENGAL,7103807,3627564,3476243,4055834,2177187,1878647,95.82857807608633
West Bengal,Nadia,23.56410971055088,88.58293034547152,336,WEST BENGAL,5167600,2653768,2513832,3480555,1878866,1601689,94.72689398621131
West Bengal,Puruliya,23.254192328767108,86.3968532876713,340,WEST BENGAL,2930115,1496996,1433119,1624905,1002058,622847,95.73298793049547
West Bengal,Uttar Dinajpur,26.044619165196977,88.23595232216337,330,WEST BENGAL,3007134,1551066,1456068,1489667,853495,636172,93.87530898104916
